###############
#S.....S.....S#
#.............#
#.............#
#.............#
#......X......#
#.....XXX.....#
#S...XXXXX...S#
#.....XXX.....#
#......X......#
#.............#
#.............#
#.............#
#S.....S.....S#
###############